bbbbbbbbbbbbbbbbbbbb
b                  b
bx      p          b
bbbbbb    bb  bbbbbb
b    b     b  b   pb
b    b     b  b    b
by   b     b  b    b
b                  b
b                  b
bp                 b
b               bbbb
b                  b
bx       p         b
bbbb               b
b                 pb
bbbbbbbb    bbbbbbbb