bbbbbbbbbbbbbbbbbbbb
b                 xb
bx      p          b
bbbbbb    bb  bbbbbb
b    b     b  b   pb
b    b     b  b    b
by   b     b       b
b          bx      b
b                  b
bp                 b
bbbbbbbbbbb   x bbbb
bp   y             b
bx                 b
bbbb               b
b                 pb
bbbbbbbb    bbbbbbbb