bbbbbbbbbbbbbbbbbbbb
b                 xb
bx      p          b
bbbbbb    bb  bbbbbb
b    b     b  b   pb
b    b     b  b    b
by   b     b  b    b
b                  b
b                  b
bp  y              b
bbbbbbbbbb  p   bbbb
b                 xb
bx                 b
bbbb               b
b                 pb
bbbbbbbb    bbbbbbbb