bbbbbbbbbbbbbbbbbbbb
b       p          b
bx                 b
b                  b
bx                 b
b                  b
b                  b
b                  b
b                  b
bp                 b
bbbbbbbbbb      bbbb
b                  b
bx                 b
bbbb               b
b                 pb
bbbbbbbb    bbbbbbbb