bbbbbbbbbbbbbbbbbbbb
b                  b
bx      p          b
bbbbbb    bb  bbbbbb
b    b     b  b   pb
b    b     b  b    b
by   b     b  b    b
b                  b
b                  b
bp                 b
bbbbbbbbbb      bbbb
b                  b
b                  b
bbbb               b
b                 pb
bbbbbbbb    bbbbbbbb